@@@@@@@@
@...S..@
@.@@.@.@
@.@@.@.@
@.@@.@.E
@.@..@.@
@.@@.@.@
@......@
@@@@@@@@