....@..E
..@.@...
..@.@..@
..@...@.
..@.@@.@
...@....
......@.
......@.
S.....@.